アシカ	アシカ
アリ	アリ
イス	イス
イチゴ	イチゴ
イヌ	イヌ
イベント	イベント
イルカ	イルカ
ウサギ	ウサギ
エビ	エビ
オムレツ	オムレツ
オレンジ	オレンジ
カエル	カエル
カップ	カップ
カニ	カニ
カブトムシ	カブトムシ
カボチャ	カボチャ
カメ	カメ
カレー	カレー
カレンダー	カレンダー
キツネ	キツネ
キノコ	キノコ
キャベツ	キャベツ
キャンプ	キャンプ
キュウリ	キュウリ
キリン	キリン
ギター	ギター
クジラ	クジラ
クマ	クマ
クラゲ	クラゲ
クラスメート	クラスメート
クラブ	クラブ
クリーム	クリーム
クリスマス	クリスマス
クレヨン	クレヨン
グラス	グラス
グローブ	グローブ
ケーキ	ケーキ
ゲーム	ゲーム
コート	コート
コーラス	コーラス
コアラ	コアラ
コウモリ	コウモリ
コメディアン	コメディアン
コンパス	コンパス
コンピュータ	コンピュータ
ゴルフ	ゴルフ
サーフィン	サーフィン
サッカー	サッカー
サツマイモ	サツマイモ
サバンナ	サバンナ
サラダ	サラダ
サル	サル
サンドイッチ	サンドイッチ
シャツ	 シャツ
ショッピング	ショッピング
ジャガイモ	ジャガイモ
ジャンプ	ジャンプ
ジャンプする	ジャンプする
ジュース	ジュース
スーパーマーケット	スーパーマーケット
スープ	スープ
スイカ	スイカ
スカート	スカート
スキー	スキー
スケート	スケート
スタジアム	スタジアム
スニーカー	スニーカー
スパイス	スパイス
スパゲッティ	スパゲッティ
スプーン	スプーン
スポーツ	スポーツ
ズボン	ズボン
セーター	セーター
ソーダ	ソーダ
ソファー	ソファー
ゾウ	ゾウ
タコ	タコ
タマネギ	タマネギ
ダンサー	ダンサー
チーズ	チーズ
チーズバーガー	チーズバーガー
チーム	チーム
テーブル	テーブル
テニス	テニス
トイレ	トイレ
トウモロコシ	トウモロコシ
トマト	トマト
トランプ	トランプ
トリ	トリ
ドーナツ	ドーナツ
ドア	ドア
ドッジボール	ドッジボール
ドレス	ドレス
ナイフ	ナイフ
ナス	ナス
ニンジン	ニンジン
ネコ	ネコ
ネズミ	ネズミ
ノート	ノート
ハムスター	ハムスター
ハロウィーン	ハロウィーン
ハンカチ	ハンカチ
ハンバーガー	ハンバーガー
バス	バス
バスケットボール	バスケットボール
バッグ	バッグ
バット	バット
バドミントン	バドミントン
バナナ	バナナ
バレーボール	バレーボール
バレエ	バレエ
パイ	パイ
パイナップル	パイナップル
パイロット	パイロット
パフェ	パフェ
パン	パン
パンや	パン屋
パンダ	パンダ
ヒトデ	ヒトデ
ビーフステーキ	ビーフステーキ
ピーマン	ピーマン
ピアニスト	ピアニスト
ピアノ	ピアノ
ピザ	ピザ
ピンク	ピンク
フォーク	フォーク
フライドポテト	フライドポテト
ブタ	ブタ
ブドウ	ブドウ
ブロッコリー	ブロッコリー
プール	プール
プリン	プリン
ヘビ	ヘビ
ベスト	ベスト
ベッド	ベッド
ペン	ペン
ペンギン	ペンギン
ホテル	ホテル
ボート	ボート
ボール	ボール
ボウル	ボウル
ボクシング	ボクシング
マーカー	マーカー
マラソン	マラソン
メロン	メロン
モール	モール
モモ	モモ
ヨーヨー	ヨーヨー
ライオン	ライオン
ラグビー	ラグビー
ラケット	ラケット
ランニング	ランニング
リコーダー	リコーダー
リンゴ	リンゴ
レストラン	レストラン
レタス	レタス
レモン	レモン
ロープ	ロープ
